########################
#.........#.......#....#
#...#.....#..###..#....#
#...#.............#....#
#..##..##...#..........#
#P.....#.G..#..##..###.#
#####..#...##..#...#...#
#...#..........#...#...#
#...#..........#.......#
#......#....#..#.......#
#....###....####..###..#
#......#.......#...#...#
#...#..............#...#
#####..#...#####...#...#
#......#.......#.......#
########################
