########################
#.........#.......#....#
#...#.....#..###..#....#
#...#.............#....#
#..##..##...#..........#
#P.....#.G..#..##..###.#
#####..#...##..#...#...#
#..............#.......#
########################
